F 119,166,101
C 91,165,212

NO textures/texture.xpm
WE textures/polished_andesite.xpm
EA textures/mossy_stone_bricks.xpm
SO textures/mossy_cobblestone.xpm

11111111111111111
10000000000000011
11111W00001111111
1100000000001001
1000000111101111
10000000001011
1100000000001
111111111111
