F 200,100,20
C 200,100,20

NO ./textures/42.xpm
SO ./textures/42.xpm
EA ./textures/42.xpm
WE ./textures/42.xpm

111111111
1000W0001
100000001
100000001
100000000
111111111
