F 119,166,101


C 91,165,212


NO textures/end_stone_bricks.xpm
SO textures/mossy_cobblestone.xpm
EA textures/mossy_stone_bricks.xpm
WE textures/polished_andesite.xpm


1111111111111
1000000000001111
110000000N00111
 100000000011
 10011111111
1101111
100000011
10000011
1110111
  111


