F 200,100,20
C 200,100,20

NO textures/texture.xpm
SO textures/texture.xpm
EA textures/texture.xpm
WE textures/texture.xpm

111111111
1000E0001
100000001
100010001
100000001
111111111
